╔═════════════════════════════════╗
║* * * * * * * * * * * * * * * *  ║
║               *                 ║
║  ╔════╗ ╔══╔═╗  ╔═══╔═══╗ ╔══╗  ║
║& ║         ║  * ║   ║   ║ ║   * ║
║  ║         ║    ║   ║   ║ ╚══╗  ║
║* ║         ║  * ║       ║    ║* ║ 
║  ╚════╝ ╚══╝    ╝       ╚ ╚══╝  ║
║* * * * * * * * * * * * * * * *  ║
║                                 ║
║  ╔═══╗  ┬  ╔═══════╗  ┬  ╔═══╗  ║
║* ║   ║* ║* ║       ║* ║* ║   ║* ║
║  ╚═══╝  ║  ╚═══╦═══╝  ║  ╚═══╝  ║
║* * * * *║* * * ║* * * ║* * * *  ║
║         ║             ║         ║
╚══════╗* ╠══┤       ├══╣* ╔══════╝
       ║  ║             ║  ║
       ║* ║             ║* ║
       ║  ║  ╔═┤___├═╗  ║  ║
       ║* ║* ║       ║* ║* ║
├══════╝  ┴  ║       ║  ┴  ╚══════┤
* * * * * *  ║       ║* * * * * * *
             ║       ║
├══════╗* ┬  ╚═══════╝  ┬* ╔══════┤
       ║  ║* * * * * *  ║  ║
       ║* ║             ║* ║
       ║  ║  ╔═══════╗  ║  ║
       ║* ║* ║       ║* ║* ║
╔══════╝  ┴  ╚═══╦═══╝  ┴  ╚══════╗
║* * * * * * * *  * * * * * * * * ║
║               *                 ║
║  ╔════╗ ╔══╔═╗  ╔═══╔═══╗ ╔══╗  ║
║* ║         ║  * ║   ║   ║ ║   * ║
║  ║         ║    ║   ║   ║ ╚══╗  ║
║* ║         ║  * ║       ║    ║* ║
║  ╚════╝ ╚══╝    ╝       ╚ ╚══╝  ║
║* * * * * * * * * * * * * * * *  ║
║                                 ║
║  ╔═══╗  ┬  ╔═══════╗  ┬  ╔═══╗  ║
║* ║   ║* ║* ║       ║* ║* ║   ║& ║
║  ╚═══╝  ┴  ╚═══════╝  ┴  ╚═══╝  ║
║* * * * * * * * * * * * * * * *  ║
║                                 ║
╚═════════════════════════════════╝