╔═════════════════════════════════╗
║                                 ║
║                                 ║
║  ╔════╗*╔════╗  ╔══╗*╔══╗*╔═══  ║
║  ║******║*****  ***║*║**║*║***  ║
║& ║******╚════╗  ╔══╝*║**║*╚══╗ &║
║  ║***********║  ║****║**║****║  ║
║  ╚════╝*╚════╝  ╚═══*╚══╝*═══╝  ║
║                                 ║
║                                 ║
║  ╔═══╗  ┬  ╔═══════╗  ┬  ╔═══╗  ║
║  ║***║  ║  ║*******║  ║  ║***║  ║
║  ╚═══╝  ║  ╚═══╦═══╝  ║  ╚═══╝  ║
║         ║      ║      ║         ║
║         ║             ║         ║
╚══════╗  ╠══┤       ├══╣  ╔══════╝
*******║  ║   *******   ║  ║
*******║  ║   *******   ║  ║
*******║  ║  ╔═┤___├═╗  ║  ║
*******║  ║  ║*******║  ║  ║
├══════╝  ┴  ║*******║  ┴  ╚══════┤
             ║*******║
             ║*******║
├══════╗  ┬  ╚═══════╝  ┬  ╔══════┤
*******║  ║             ║  ║
*******║  ║             ║  ║
*******║  ║  ╔═══════╗  ║  ║
*******║  ║  ║*******║  ║  ║
╔══════╝  ┴  ╚═══╦═══╝  ┴  ╚══════╗
║                ║                ║
║                ║                ║
║  ├═══╗  ├═══┤  ┴  ├═══┤  ╔═══┤  ║
║      ║                   ║      ║
║      ║                   ║      ║
╠═══╗  ║  ┬  ╔═══════╗  ┬  ║  ╔═══╣
║***║  ║  ║  ║*******║  ║  ║  ║***║
╠═══╝  ┴  ║  ╚═══╦═══╝  ║  ┴  ╚═══╣
║         ║      ║      ║         ║
║         ║      ║      ║         ║
║ &├══════╩═══┤  ┴  ├═══╩══════┤& ║
║                                 ║
║                                 ║
╚═════════════════════════════════╝