╔════════════════╦════════════════╗
║                ║                ║
║                ║                ║
║  ╔═══╗  ╔═══╗  ║  ╔═══╗  ╔═══╗  ║
║  ║   ║  ║   ║  ║  ║   ║  ║   ║  ║
║  ║   ║  ║   ║  ║  ║   ║  ║   ║  ║
║  ╚═══╝  ╚═══╝  ║  ╚═══╝  ╚═══╝  ║
║                                 ║
║                                 ║
║  ╔═══╗  ┬  ╔═══════╗  ┬  ╔═══╗  ║
║  ║   ║  ║  ║       ║  ║  ║   ║  ║
║  ╚═══╝  ║  ╚═══╦═══╝  ║  ╚═══╝  ║
║         ║      ║      ║         ║
║         ║             ║         ║
╚══════╗  ╠══┤       ├══╣  ╔══════╝
       ║  ║             ║  ║
       ║  ║             ║  ║
       ║  ║  ╔═┤___├═╗  ║  ║
       ║  ║  ║       ║  ║  ║
├══════╝  ┴  ║       ║  ┴  ╚══════┤
             ║       ║
             ║       ║
├══════╗  ┬  ╚═══════╝  ┬  ╔══════┤
       ║  ║             ║  ║
       ║  ║             ║  ║
       ║  ║  ╔═══════╗  ║  ║
       ║  ║  ║       ║  ║  ║
╔══════╝  ┴  ╚═══╦═══╝  ┴  ╚══════╗
║                ║                ║
║                ║                ║
║  ├═══╗  ├═══┤  ┴  ├═══┤  ╔═══┤  ║
║      ║                   ║      ║
║      ║                   ║      ║
╠═══╗  ║  ┬  ╔═══════╗  ┬  ║  ╔═══╣
║   ║  ║  ║  ║       ║  ║  ║  ║   ║
╠═══╝  ┴  ║  ╚═══╦═══╝  ║  ┴  ╚═══╣
║         ║      ║      ║         ║
║         ║      ║      ║         ║
║  ├══════╩═══┤  ┴  ├═══╩══════┤  ║
║                                 ║
║                                 ║
╚═════════════════════════════════╝