╔═════════════════════════════════╗
║* * * * * * * * * * * * * * * *  ║
║               *                 ║
║  ╔════╗ ╔════╗  ╔══╗ ╔══╗ ╔═══  ║
║& ║      ║     *    ║ ║  ║ ║   & ║
║  ║      ╚════╗  ╔══╝ ║  ║ ╚══╗  ║
║* ║           ║* ║    ║  ║    ║* ║
║  ╚════╝ ╚════╝  ╚═══ ╚══╝ ═══╝  ║
║* * * * * * * * * * * * * * * *  ║
║                                 ║
║  ╔═══╗  ┬  ╔═══════╗  ┬  ╔═══╗  ║
║* ║   ║* ║* ║       ║* ║* ║   ║* ║
║  ╚═══╝  ║  ╚═══╦═══╝  ║  ╚═══╝  ║
║* * * * *║* * * ║* * * ║* * * *  ║
║         ║             ║         ║
╚══════╗* ╠══┤       ├══╣* ╔══════╝
       ║  ║             ║  ║
       ║* ║             ║* ║
       ║  ║  ╔═┤___├═╗  ║  ║
       ║* ║* ║       ║* ║* ║
├══════╝  ┴  ║       ║  ┴  ╚══════┤
* * * * * *  ║       ║* * * * * * *
             ║       ║
├══════╗* ┬  ╚═══════╝  ┬* ╔══════┤
       ║  ║* * * * * *  ║  ║
       ║* ║             ║* ║
       ║  ║  ╔═══════╗  ║  ║
       ║* ║* ║       ║* ║* ║
╔══════╝  ┴  ╚═══╦═══╝  ┴  ╚══════╗
║* * * * * * * * ║* * * * * * * * ║
║                ║                ║
║* ├═══╗  ├═══┤  ┴  ├═══┤  ╔═══┤* ║
║  * * ║* * * * * * * * *  ║* *   ║
║      ║                   ║      ║
╠═══╗  ║  ┬  ╔═══════╗  ┬  ║  ╔═══╣
║   ║* ║* ║* ║       ║* ║* ║* ║   ║
╠═══╝  ┴  ║  ╚═══╦═══╝  ║  ┴  ╚═══╣
║* * * * *║* * * ║* * * ║* * * *  ║
║         ║      ║      ║         ║
║& ├══════╩═══┤  ┴  ├═══╩══════┤& ║
║* * * * * * * * * * * * * * * *  ║
║                                 ║
╚═════════════════════════════════╝